~~~~ APPS ~~~~
firefox = SUPER + B
bottles = SUPER + ALT + B
discord = SUPER + D
filezilla = SUPER + F
virt-manager = SUPER + V
zoom = SUPER + Z
screenshotarea = SUPER + SHIFT + S
swaylock = SUPER + L
kitty = SUPER + T
nautilus = SUPER + E
rofi = SUPER + S
wlogout = SUPER + escape

~~~~ Window Manager ~~~~
kill window = SUPER + Q
exit session = SUPER + CTRL + Q
fullscreen = SUPER + CTRL + F
togglefloating = SUPER + CTRL + Space
togglesplit = SUPER + CTRL + S

movefocusleft = SUPER + left
movefocusright = SUPER + right
movefocusup = SUPER + up
movefocusdown = SUPER + down

movewindowleft = SUPER SHIFT + left
movewindowright = SUPER SHIFT + right
movewindowup = SUPER SHIFT + up
movewindowdown = SUPER SHIFT + down

resizeleft = SUPER + SHIFT + left
resizeright = SUPER + SHIFT + right
resizeup = SUPER + SHIFT + up
resizedown = SUPER + SHIFT + down

togglespecialworkspace = SUPER + grave
workspace 1-10 = SUPER + 0-9
workspaceup = SUPER + CTRL + up
workspacedown = SUPER + CTRL + down
movetoworkspace 1-10 = SUPER + CTRL + 0-9

movewindow (Mouse) = SUPER + mouse:272
resizewindow (Mouse) = SUPER + mouse:273
workspaceup (Mouse) = SUPER + mouse_up
workspacedown (Mouse) = SUPER + mouse_down